111111
100P01
100C01
100E01
111111
