11111111111111111
100P01000001
100C01000001
100E00000001
100C01000001
111111111111